1111111111111
1111111011111
1C11000000001
1100011111001
1P0011E0000C1
1111111111111