1111111111111111111111111111111111111111111111111111111111111111111
1E000000000C0000000000000000000000000000000000000000000000000011111
1P000000C0000000000000000000000000000000000000000000000000000011111
1111111000000000000000000000000000000000000000000000000000000011111
11111C0000000000000000000000000000000000000000000000000000000011111
11111C0000000000000000000000000000000000000000000000000000000011111
11111C0000000000000000000000000000000000000000000000000000000011111
11111C0000000000000000000000000000000000000000000000000000000011111
11111C0000000000000000000000000000000000000000000000000000000011111
11111C0000000000000000000000000000000000000000000000000000000011111
11111C0000000000000000000000000000000000000000000000000000000011111
11111C0000000000000000000000000000000000000000000000000000000011111
11111C0000000000000000000000000000000000000000000000000000000011111
11111C0000000000000000000000000000000000000000000000000000000011111
11111C0000000000000000000000000000000000000000000000000000000011111
11111C0000000000000000000000000000000000000000000000000000000011111
11111C0000000000000000000000000000000000000000000000000000000011111
11111C0000000000000000000000000000000000000000000000000000000011111
11111C0000000000000000000000000000000000000000000000000000000011111
11111C0000000000000000000000000000000000000000000000000000000011111
11111C0000000000000000000000000000000000000000000000000000000011111
11111C0000000000000000000000000000000000000000000000000000000011111
11111C0000000000000000000000000000000000000000000000000000000011111
11111C0000000000000000000000000000000000000000000000000000000011111
11111C0000000000000000000000000000000000000000000000000000000011111
11111C0000000000000000000000000000000000000000000000000000000011111
11111C0000000000000000000000000000000000000000000000000000000011111
11111C0000000000000000000000000000000000000000000000000000000011111
11111C0000000000000000000000000000000000000000000000000000000011111
11111C0000000000000000000000000000000000000000000000000000000011111
11111C0000000000000000000000000000000000000000000000000000000011111
11111C0000000000000000000000000000000000000000000000000000000011111
11111C0000000000000000000000000000000000000000000000000000000011111
11111C0000000000000000000000000000000000000000000000000000000011111
1111111111111111111111111111111111111111111111111111111111111111111