11111111111111
1E000000000C01
1P000000C00001
11111110000001
11111C00000001
111100000000C1
11111111111111